1111111111111
1001000000E01
10P0011111001
1000110000001
1111111111111
