11111111
1P00C0E1
11100001
11111111