11111111111111111111
1000C0E01CCC00000001
11100000000000000001
10000001000000000P11
11111111111111111111