1111111111111
1001000C00E01
100P011111001
1000110000001
1111111111111
