1111111111111
1001000C00E01
100P011111001
1000110000001
1000000000001
1001000C00001
1000011111001
1000110000001
1111111111111