111111111
1P00C0E01
111000001
100000001
111111111