111111111111111111111
1000000000000000000C1
1000000000PE000111111
1000000000000000C0001
111111111111111111111