1111111111111111111111111111111111111111111111111111111111111111111111111
1P001000000000000000000000000000000111E0000000000000000000000000000000011
1110001000010000000000000000000000001111111111111111111111111111111111001
1001100100010000000000000000000000011000000001110000000000000000000110011
1000110010100000000000000000001000011000001001000000000000000100000110011
1000010001111111111111111111111111111000001001000000000000000000000110011
1000001000000000000000000000000000001100000100100000000000000000000011001
1000000111111111111111111111111110111000001000000000000000000000000110C01
1000000000000000000000100000000010001000001011111111111111111111111110011
1100000000000000000000000000000010000000001000000000011000000000000000011
1100000000000000000000000000000001111110000000000000000000000000000000111
1000000000100000000000000000000000011111111111111111111111111111111110011
1000000000010000000000000000000000011000000001110000000000000000000110011
1000100000100000000000000000001000011000001001000000000000000100000110011
1000000000000000000000000000000000011000001001000000000000000000000110011
10000000000C0000000000000000000000011000001001000000000000000000000110011
1000000000000000000001011000000000111000001000000000000000000000000110001
1000000000000000000000100000000000001000001011111111111111111101111110011
1100000000000000000000000000000000000000001000000000011000000000000000011
1111111111111111111111111111111111111111111111111111111111111111111111111
