1111111111111
1ECCCCCCCC011
10C00000000P1
1111111111111