1111111111111111111111
100C1011CCC00000100001
11101E1000000000010001
1000000100000000000001
1000000000000000000001
1000C0001CCC0000001001
1110000000000000001001
1000000100000000011001
1000C0001CCC0000001001
1110000000000000001001
1000000100000000000001
100000000000000000P001
1111111111111111111111